ReqId,ReqAddr,RefTraceCycle,ReqBusLatency,RespBusLatency,ReplcLatency,LatencyMinusRepl,TotLatency,WcReqLatency,WcRespLatency,WcReplcLatency,WcLatency,WcLatencyMinsRepl,AverageLatency
1,1000000,0,4,141,0,145,145,4,141,0,145,145,145
5,1000064,50,47,96,0,143,143,47,141,0,145,145,144
23,1000128,100,97,140,0,237,237,97,141,0,237,237,175
27,1000192,150,23,128,0,151,151,97,141,0,237,237,169
35,1000256,200,31,124,0,155,155,97,141,0,237,237,166
40,1000320,250,23,128,0,151,151,97,141,0,237,237,163
44,1000384,300,31,124,0,155,155,97,141,0,237,237,162
49,1000448,350,15,112,0,127,127,97,141,0,237,237,158
53,1000512,400,23,128,0,151,151,97,141,0,237,237,157
57,1000576,450,23,128,0,151,151,97,141,0,237,237,156
61,1000640,500,31,124,0,155,155,97,141,0,237,237,156
66,1000704,550,23,128,0,151,151,97,141,0,237,237,156
70,1000768,600,31,124,0,155,155,97,141,0,237,237,155
75,1000832,650,15,112,0,127,127,97,141,0,237,237,153
79,1000896,700,23,128,0,151,151,97,141,0,237,237,153
83,1000960,750,23,128,0,151,151,97,141,0,237,237,153
87,1001024,800,31,124,0,155,155,97,141,0,237,237,153
92,1001088,850,23,128,0,151,151,97,141,0,237,237,153
96,1001152,900,31,124,0,155,155,97,141,0,237,237,153
101,1001216,950,15,112,0,127,127,97,141,0,237,237,152
105,1001280,1000,23,128,0,151,151,97,141,0,237,237,152
109,1001344,1050,23,128,0,151,151,97,141,0,237,237,152
113,1001408,1100,31,124,0,155,155,97,141,0,237,237,152
118,1001472,1150,23,128,0,151,151,97,141,0,237,237,152
122,1001536,1200,31,124,0,155,155,97,141,0,237,237,152
127,1001600,1250,15,112,0,127,127,97,141,0,237,237,151
131,1001664,1300,23,128,0,151,151,97,141,0,237,237,151
135,1001728,1350,23,128,0,151,151,97,141,0,237,237,151
139,1001792,1400,31,124,0,155,155,97,141,0,237,237,151
144,1001856,1450,23,128,0,151,151,97,141,0,237,237,151
148,1001920,1500,31,124,0,155,155,97,141,0,237,237,151
153,1001984,1550,15,112,0,127,127,97,141,0,237,237,150
157,1002048,1600,23,128,0,151,151,97,141,0,237,237,150
161,1002112,1650,23,128,0,151,151,97,141,0,237,237,150
165,1002176,1700,31,124,0,155,155,97,141,0,237,237,150
170,1002240,1750,23,128,0,151,151,97,141,0,237,237,150
174,1002304,1800,31,124,0,155,155,97,141,0,237,237,151
179,1002368,1850,15,112,0,127,127,97,141,0,237,237,150
183,1002432,1900,23,128,0,151,151,97,141,0,237,237,150
187,1002496,1950,23,128,0,151,151,97,141,0,237,237,150
191,1002560,2000,31,124,0,155,155,97,141,0,237,237,150
196,1002624,2050,23,128,0,151,151,97,141,0,237,237,150
200,1002688,2100,31,124,0,155,155,97,141,0,237,237,150
205,1002752,2150,15,112,0,127,127,97,141,0,237,237,150
209,1002816,2200,23,128,0,151,151,97,141,0,237,237,150
213,1002880,2250,23,128,0,151,151,97,141,0,237,237,150
217,1002944,2300,31,124,0,155,155,97,141,0,237,237,150
222,1003008,2350,23,128,0,151,151,97,141,0,237,237,150
226,1003072,2400,31,124,0,155,155,97,141,0,237,237,150
231,1003136,2450,15,112,0,127,127,97,141,0,237,237,149
235,1003200,2500,23,128,0,151,151,97,141,0,237,237,149
239,1003264,2550,23,128,0,151,151,97,141,0,237,237,149
243,1003328,2600,31,124,0,155,155,97,141,0,237,237,150
248,1003392,2650,23,128,0,151,151,97,141,0,237,237,150
252,1003456,2700,31,124,0,155,155,97,141,0,237,237,150
257,1003520,2750,15,112,0,127,127,97,141,0,237,237,149
261,1003584,2800,23,128,0,151,151,97,141,0,237,237,149
265,1003648,2850,23,128,0,151,151,97,141,0,237,237,149
269,1003712,2900,31,124,0,155,155,97,141,0,237,237,149
274,1003776,2950,23,128,0,151,151,97,141,0,237,237,149
278,1003840,3000,31,124,0,155,155,97,141,0,237,237,149
283,1003904,3050,15,112,0,127,127,97,141,0,237,237,149
287,1003968,3100,23,128,0,151,151,97,141,0,237,237,149
291,1004032,3150,23,128,0,151,151,97,141,0,237,237,149
295,1004096,3200,31,124,0,155,155,97,141,0,237,237,149
300,1004160,3250,23,128,0,151,151,97,141,0,237,237,149
304,1004224,3300,31,124,0,155,155,97,141,0,237,237,149
309,1004288,3350,15,112,0,127,127,97,141,0,237,237,149
313,1004352,3400,23,128,0,151,151,97,141,0,237,237,149
317,1004416,3450,23,128,0,151,151,97,141,0,237,237,149
321,1004480,3500,31,124,0,155,155,97,141,0,237,237,149
326,1004544,3550,23,128,0,151,151,97,141,0,237,237,149
330,1004608,3600,31,124,0,155,155,97,141,0,237,237,149
335,1004672,3650,15,112,0,127,127,97,141,0,237,237,149
339,1004736,3700,23,128,0,151,151,97,141,0,237,237,149
343,1004800,3750,23,128,0,151,151,97,141,0,237,237,149
347,1004864,3800,31,124,0,155,155,97,141,0,237,237,149
352,1004928,3850,23,128,0,151,151,97,141,0,237,237,149
356,1004992,3900,31,124,0,155,155,97,141,0,237,237,149
361,1005056,3950,15,112,0,127,127,97,141,0,237,237,149
365,1005120,4000,23,128,0,151,151,97,141,0,237,237,149
369,1005184,4050,23,128,0,151,151,97,141,0,237,237,149
373,1005248,4100,31,124,0,155,155,97,141,0,237,237,149
378,1005312,4150,23,128,0,151,151,97,141,0,237,237,149
382,1005376,4200,31,124,0,155,155,97,141,0,237,237,149
387,1005440,4250,15,112,0,127,127,97,141,0,237,237,149
391,1005504,4300,23,128,0,151,151,97,141,0,237,237,149
395,1005568,4350,23,128,0,151,151,97,141,0,237,237,149
