ReqId,ReqAddr,RefTraceCycle,ReqBusLatency,RespBusLatency,ReplcLatency,LatencyMinusRepl,TotLatency,WcReqLatency,WcRespLatency,WcReplcLatency,WcLatency,WcLatencyMinsRepl,AverageLatency
2,1111000,0,8,77,0,85,85,8,77,0,85,85,85
10,1111192,0,25,100,0,125,125,25,100,0,125,125,105
11,1111256,0,28,20,0,48,48,28,100,0,125,125,86
6,1111064,0,19,20,0,39,39,28,100,0,125,125,74
15,1111512,0,38,80,0,118,118,38,100,0,125,125,83
17,1111640,0,23,20,0,43,43,38,100,0,125,125,76
12,1111320,0,31,60,0,91,91,38,100,0,125,125,78
9,1111128,0,22,20,0,42,42,38,100,0,125,125,73
14,1111448,0,36,40,0,76,76,38,100,0,125,125,74
16,1111576,0,41,100,0,141,141,41,100,0,141,141,80
13,1111384,0,33,20,0,53,53,41,100,0,141,141,78
30,1112088,0,15,100,0,115,115,41,100,0,141,141,81
20,1111832,0,52,40,0,92,92,52,100,0,141,141,82
32,1112152,0,63,20,0,83,83,63,100,0,141,141,82
18,1111704,0,4,20,0,24,24,63,100,0,141,141,78
21,1111896,0,4,100,0,104,104,63,100,0,141,141,79
25,1112024,0,17,20,0,37,37,63,100,0,141,141,77
37,1112344,0,4,20,0,24,24,63,100,0,141,141,74
19,1111768,0,99,20,0,119,119,99,100,0,141,141,76
43,1112472,0,137,80,0,217,217,137,100,0,217,217,83
48,1112600,0,4,20,0,24,24,137,100,0,217,217,80
33,1112216,0,129,20,0,149,149,137,100,0,217,217,84
22,1111960,0,23,40,0,63,63,137,100,0,217,217,83
41,1112408,0,129,80,0,209,209,137,100,0,217,217,88
46,1112536,0,71,20,0,91,91,137,100,0,217,217,88
36,1112280,0,67,20,0,87,87,137,100,0,217,217,88
50,1112728,0,99,60,0,159,159,137,100,0,217,217,91
52,1112856,0,4,20,0,24,24,137,100,0,217,217,88
49,1112664,0,4,80,0,84,84,137,100,0,217,217,88
58,1113112,0,4,40,0,44,44,137,100,0,217,217,87
63,1113240,0,23,20,0,43,43,137,100,0,217,217,85
67,1113368,0,4,20,0,24,24,137,100,0,217,217,83
51,1112792,0,52,80,0,132,132,137,100,0,217,217,85
53,1112920,0,4,40,0,44,44,137,100,0,217,217,83
68,1113432,0,4,20,0,24,24,137,100,0,217,217,82
71,1113496,0,4,20,0,24,24,137,100,0,217,217,80
65,1113304,0,4,120,0,124,124,137,120,0,217,217,81
82,1113880,0,83,20,0,103,103,137,120,0,217,217,82
56,1112984,0,89,20,0,109,109,137,120,0,217,217,83
59,1113176,0,4,120,0,124,124,137,120,0,217,217,84
75,1113688,0,7,20,0,27,27,137,120,0,217,217,82
80,1113816,0,4,20,0,24,24,137,120,0,217,217,81
72,1113560,0,4,20,0,24,24,137,120,0,217,217,79
57,1113048,0,47,20,0,67,67,137,120,0,217,217,79
77,1113752,0,4,80,0,84,84,137,120,0,217,217,79
84,1113944,0,4,20,0,24,24,137,120,0,217,217,78
86,1114072,0,27,20,0,47,47,137,120,0,217,217,77
73,1113624,0,9,40,0,49,49,137,120,0,217,217,77
87,1114136,0,4,80,0,84,84,137,120,0,217,217,77
89,1114264,0,4,20,0,24,24,137,120,0,217,217,76
85,1114008,0,49,20,0,69,69,137,120,0,217,217,76
88,1114200,0,4,80,0,84,84,137,120,0,217,217,76
99,1114584,0,9,80,0,89,89,137,120,0,217,217,76
92,1114328,0,91,20,0,111,111,137,120,0,217,217,77
100,1114648,0,43,80,0,123,123,137,120,0,217,217,78
102,1114712,0,4,20,0,24,24,137,120,0,217,217,77
103,1114776,0,4,20,0,24,24,137,120,0,217,217,76
93,1114392,0,48,60,0,108,108,137,120,0,217,217,76
98,1114520,0,4,60,0,64,64,137,120,0,217,217,76
112,1115032,0,47,80,0,127,127,137,120,0,217,217,77
94,1114456,0,4,20,0,24,24,137,120,0,217,217,76
116,1115160,0,4,80,0,84,84,137,120,0,217,217,76
109,1114904,0,55,20,0,75,75,137,120,0,217,217,76
120,1115288,0,31,20,0,51,51,137,120,0,217,217,76
108,1114840,0,89,80,0,169,169,137,120,0,217,217,77
132,1115672,0,4,80,0,84,84,137,120,0,217,217,77
111,1114968,0,89,20,0,109,109,137,120,0,217,217,78
123,1115416,0,9,60,0,69,69,137,120,0,217,217,77
127,1115544,0,4,20,0,24,24,137,120,0,217,217,77
115,1115096,0,4,80,0,84,84,137,120,0,217,217,77
117,1115224,0,4,60,0,64,64,137,120,0,217,217,77
136,1115800,0,51,100,0,151,151,137,120,0,217,217,78
139,1115928,0,4,20,0,24,24,137,120,0,217,217,77
142,1116056,0,31,20,0,51,51,137,120,0,217,217,77
122,1115352,0,4,20,0,24,24,137,120,0,217,217,76
140,1115992,0,49,100,0,149,149,137,120,0,217,217,77
137,1115864,0,28,20,0,48,48,137,120,0,217,217,76
146,1116120,0,66,20,0,86,86,137,120,0,217,217,77
126,1115480,0,7,20,0,27,27,137,120,0,217,217,76
152,1116312,0,135,80,0,215,215,137,120,0,217,217,78
156,1116440,0,4,20,0,24,24,137,120,0,217,217,77
149,1116184,0,12,20,0,32,32,137,120,0,217,217,76
158,1116504,0,4,20,0,24,24,137,120,0,217,217,76
129,1115608,0,4,60,0,64,64,137,120,0,217,217,76
135,1115736,0,54,100,0,154,154,137,120,0,217,217,77
162,1116632,0,48,80,0,128,128,137,120,0,217,217,77
164,1116696,0,4,20,0,24,24,137,120,0,217,217,77
166,1116760,0,4,20,0,24,24,137,120,0,217,217,76
154,1116376,0,70,20,0,90,90,137,120,0,217,217,76
150,1116248,0,8,60,0,68,68,137,120,0,217,217,76
172,1116952,0,59,80,0,139,139,137,120,0,217,217,77
160,1116568,0,91,20,0,111,111,137,120,0,217,217,77
181,1117272,0,89,80,0,169,169,137,120,0,217,217,78
170,1116824,0,4,80,0,84,84,137,120,0,217,217,78
179,1117144,0,4,60,0,64,64,137,120,0,217,217,78
173,1117016,0,44,60,0,104,104,137,120,0,217,217,78
188,1117400,0,4,20,0,24,24,137,120,0,217,217,78
