ReqId,ReqAddr,RefTraceCycle,ReqBusLatency,RespBusLatency,ReplcLatency,LatencyMinusRepl,TotLatency,WcReqLatency,WcRespLatency,WcReplcLatency,WcLatency,WcLatencyMinsRepl,AverageLatency
2,1111000,0,8,57,0,65,65,8,57,0,65,65,65
6,1111064,0,19,60,0,79,79,19,60,0,79,79,72
9,1111128,0,22,20,0,42,42,22,60,0,79,79,62
10,1111192,0,25,20,0,45,45,25,60,0,79,79,57
11,1111256,0,28,20,0,48,48,28,60,0,79,79,55
13,1111384,0,33,120,0,153,153,33,120,0,153,153,72
14,1111448,0,36,20,0,56,56,36,120,0,153,153,69
15,1111512,0,38,20,0,58,58,38,120,0,153,153,68
16,1111576,0,41,20,0,61,61,41,120,0,153,153,67
17,1111640,0,4,20,0,24,24,41,120,0,153,153,63
12,1111320,0,31,20,0,51,51,41,120,0,153,153,62
19,1111768,0,8,100,0,108,108,41,120,0,153,153,65
20,1111832,0,4,20,0,24,24,41,120,0,153,153,62
21,1111896,0,4,20,0,24,24,41,120,0,153,153,59
18,1111704,0,4,20,0,24,24,41,120,0,153,153,57
25,1112024,0,4,120,0,124,124,41,120,0,153,153,61
28,1112088,0,4,20,0,24,24,41,120,0,153,153,59
30,1112152,0,129,20,0,149,149,129,120,0,153,153,64
31,1112216,0,145,40,0,185,185,145,120,0,185,185,70
22,1111960,0,4,20,0,24,24,145,120,0,185,185,68
33,1112280,0,79,60,0,139,139,145,120,0,185,185,71
38,1112408,0,4,80,0,84,84,145,120,0,185,185,72
40,1112472,0,129,20,0,149,149,145,120,0,185,185,75
41,1112536,0,67,20,0,87,87,145,120,0,185,185,76
43,1112600,0,4,20,0,24,24,145,120,0,185,185,74
45,1112664,0,4,20,0,24,24,145,120,0,185,185,72
36,1112344,0,4,20,0,24,24,145,120,0,185,185,70
50,1112792,0,103,100,0,203,203,145,120,0,203,203,75
51,1112856,0,111,20,0,131,131,145,120,0,203,203,77
49,1112728,0,4,20,0,24,24,145,120,0,203,203,75
53,1112984,0,4,100,0,104,104,145,120,0,203,203,76
54,1113048,0,4,20,0,24,24,145,120,0,203,203,74
55,1113112,0,4,40,0,44,44,145,120,0,203,203,73
65,1113368,0,4,40,0,44,44,145,120,0,203,203,72
52,1112920,0,62,20,0,82,82,145,120,0,203,203,73
68,1113496,0,63,100,0,163,163,145,120,0,203,203,75
71,1113624,0,4,20,0,24,24,145,120,0,203,203,74
74,1113688,0,4,20,0,24,24,145,120,0,203,203,72
57,1113176,0,129,20,0,149,149,145,120,0,203,203,74
59,1113240,0,137,60,0,197,197,145,120,0,203,203,77
76,1113752,0,49,80,0,129,129,145,120,0,203,203,79
78,1113880,0,4,20,0,24,24,145,120,0,203,203,77
81,1114008,0,49,20,0,69,69,145,120,0,203,203,77
61,1113304,0,75,40,0,115,115,145,120,0,203,203,78
70,1113560,0,4,80,0,84,84,145,120,0,203,203,78
83,1114136,0,23,80,0,103,103,145,120,0,203,203,79
89,1114328,0,89,20,0,109,109,145,120,0,203,203,79
66,1113432,0,4,20,0,24,24,145,120,0,203,203,78
88,1114264,0,4,100,0,104,104,145,120,0,203,203,79
91,1114392,0,47,20,0,67,67,145,120,0,203,203,78
82,1114072,0,35,20,0,55,55,145,120,0,203,203,78
77,1113816,0,31,20,0,51,51,145,120,0,203,203,77
97,1114520,0,89,80,0,169,169,145,120,0,203,203,79
99,1114584,0,105,20,0,125,125,145,120,0,203,203,80
85,1114200,0,4,60,0,64,64,145,120,0,203,203,80
93,1114456,0,4,20,0,24,24,145,120,0,203,203,79
80,1113944,0,4,20,0,24,24,145,120,0,203,203,78
103,1114776,0,4,80,0,84,84,145,120,0,203,203,78
100,1114648,0,59,60,0,119,119,145,120,0,203,203,78
115,1115096,0,89,80,0,169,169,145,120,0,203,203,80
118,1115224,0,55,20,0,75,75,145,120,0,203,203,80
108,1114968,0,4,20,0,24,24,145,120,0,203,203,79
102,1114712,0,4,20,0,24,24,145,120,0,203,203,78
105,1114840,0,89,20,0,109,109,145,120,0,203,203,79
110,1115032,0,4,120,0,124,124,145,120,0,203,203,79
131,1115672,0,43,40,0,83,83,145,120,0,203,203,79
117,1115160,0,105,20,0,125,125,145,120,0,203,203,80
106,1114904,0,47,20,0,67,67,145,120,0,203,203,80
122,1115352,0,43,80,0,123,123,145,120,0,203,203,80
125,1115480,0,4,20,0,24,24,145,120,0,203,203,80
133,1115800,0,89,80,0,169,169,145,120,0,203,203,81
119,1115288,0,43,20,0,63,63,145,120,0,203,203,81
123,1115416,0,4,60,0,64,64,145,120,0,203,203,80
138,1116056,0,43,100,0,143,143,145,120,0,203,203,81
135,1115928,0,55,20,0,75,75,145,120,0,203,203,81
144,1116184,0,51,40,0,91,91,145,120,0,203,203,81
127,1115544,0,4,20,0,24,24,145,120,0,203,203,80
128,1115608,0,4,60,0,64,64,145,120,0,203,203,80
137,1115992,0,4,80,0,84,84,145,120,0,203,203,80
143,1116120,0,89,20,0,109,109,145,120,0,203,203,81
146,1116248,0,70,20,0,90,90,145,120,0,203,203,81
147,1116312,0,4,20,0,24,24,145,120,0,203,203,80
160,1116696,0,4,20,0,24,24,145,120,0,203,203,79
132,1115736,0,4,20,0,24,24,145,120,0,203,203,79
153,1116504,0,95,100,0,195,195,145,120,0,203,203,80
155,1116568,0,54,20,0,74,74,145,120,0,203,203,80
158,1116632,0,4,20,0,24,24,145,120,0,203,203,79
134,1115864,0,105,20,0,125,125,145,120,0,203,203,80
152,1116440,0,4,120,0,124,124,145,120,0,203,203,80
162,1116824,0,129,20,0,149,149,145,120,0,203,203,81
166,1116952,0,75,20,0,95,95,145,120,0,203,203,81
170,1117016,0,4,20,0,24,24,145,120,0,203,203,81
176,1117272,0,4,20,0,24,24,145,120,0,203,203,80
150,1116376,0,4,20,0,24,24,145,120,0,203,203,79
171,1117080,0,4,100,0,104,104,145,120,0,203,203,80
173,1117144,0,129,20,0,149,149,145,120,0,203,203,80
175,1117208,0,67,20,0,87,87,145,120,0,203,203,80
161,1116760,0,4,20,0,24,24,145,120,0,203,203,80
185,1117592,0,82,80,0,162,162,145,120,0,203,203,81
190,1117784,0,89,80,0,169,169,145,120,0,203,203,82
191,1117848,0,47,20,0,67,67,145,120,0,203,203,81
163,1116888,0,137,20,0,157,157,145,120,0,203,203,82
182,1117400,0,4,80,0,84,84,145,120,0,203,203,82
179,1117336,0,4,60,0,64,64,145,120,0,203,203,82
183,1117464,0,135,80,0,215,215,145,120,0,215,215,83
188,1117656,0,4,20,0,24,24,145,120,0,215,215,83
184,1117528,0,151,20,0,171,171,151,120,0,215,215,83
194,1117912,0,4,20,0,24,24,151,120,0,215,215,83
201,1118168,0,23,140,0,163,163,151,140,0,215,215,84
202,1118232,0,43,20,0,63,63,151,140,0,215,215,83
206,1118360,0,4,20,0,24,24,151,140,0,215,215,83
189,1117720,0,4,20,0,24,24,151,140,0,215,215,82
200,1118104,0,59,160,0,219,219,151,160,0,219,219,84
216,1118680,0,89,20,0,109,109,151,160,0,219,219,84
195,1117976,0,89,20,0,109,109,151,160,0,219,219,84
210,1118488,0,4,100,0,104,104,151,160,0,219,219,84
217,1118744,0,47,20,0,67,67,151,160,0,219,219,84
214,1118616,0,4,20,0,24,24,151,160,0,219,219,84
213,1118552,0,4,40,0,44,44,151,160,0,219,219,83
204,1118296,0,4,20,0,24,24,151,160,0,219,219,83
199,1118040,0,105,20,0,125,125,151,160,0,219,219,83
208,1118424,0,4,100,0,104,104,151,160,0,219,219,83
226,1119064,0,4,80,0,84,84,151,160,0,219,219,83
232,1119192,0,4,20,0,24,24,151,160,0,219,219,83
219,1118808,0,135,20,0,155,155,151,160,0,219,219,83
235,1119256,0,49,20,0,69,69,151,160,0,219,219,83
225,1119000,0,4,100,0,104,104,151,160,0,219,219,83
227,1119128,0,8,20,0,28,28,151,160,0,219,219,83
239,1119384,0,43,20,0,63,63,151,160,0,219,219,83
220,1118872,0,151,20,0,171,171,151,160,0,219,219,83
240,1119448,0,4,120,0,124,124,151,160,0,219,219,84
242,1119512,0,4,20,0,24,24,151,160,0,219,219,83
243,1119576,0,4,20,0,24,24,151,160,0,219,219,83
245,1119640,0,4,20,0,24,24,151,160,0,219,219,82
224,1118936,0,82,20,0,102,102,151,160,0,219,219,83
247,1119704,0,4,100,0,104,104,151,160,0,219,219,83
249,1119768,0,4,20,0,24,24,151,160,0,219,219,82
251,1119832,0,4,20,0,24,24,151,160,0,219,219,82
256,1120024,0,4,20,0,24,24,151,160,0,219,219,81
236,1119320,0,31,20,0,51,51,151,160,0,219,219,81
254,1119960,0,4,100,0,104,104,151,160,0,219,219,81
267,1120344,0,4,20,0,24,24,151,160,0,219,219,81
259,1120088,0,129,20,0,149,149,151,160,0,219,219,81
252,1119896,0,47,40,0,87,87,151,160,0,219,219,81
261,1120216,0,79,80,0,159,159,151,160,0,219,219,82
263,1120280,0,4,20,0,24,24,151,160,0,219,219,82
269,1120472,0,129,20,0,149,149,151,160,0,219,219,82
260,1120152,0,145,60,0,205,205,151,160,0,219,219,83
273,1120600,0,4,80,0,84,84,151,160,0,219,219,83
278,1120728,0,4,20,0,24,24,151,160,0,219,219,82
279,1120792,0,43,20,0,63,63,151,160,0,219,219,82
268,1120408,0,4,60,0,64,64,151,160,0,219,219,82
284,1121048,0,47,60,0,107,107,151,160,0,219,219,82
286,1121176,0,4,60,0,64,64,151,160,0,219,219,82
281,1120920,0,4,20,0,24,24,151,160,0,219,219,82
271,1120536,0,67,40,0,107,107,151,160,0,219,219,82
277,1120664,0,4,60,0,64,64,151,160,0,219,219,82
295,1121432,0,4,80,0,84,84,151,160,0,219,219,82
280,1120856,0,4,60,0,64,64,151,160,0,219,219,82
290,1121240,0,4,60,0,64,64,151,160,0,219,219,82
283,1120984,0,4,20,0,24,24,151,160,0,219,219,81
298,1121560,0,31,60,0,91,91,151,160,0,219,219,81
285,1121112,0,4,80,0,84,84,151,160,0,219,219,81
291,1121304,0,23,60,0,83,83,151,160,0,219,219,81
301,1121688,0,43,20,0,63,63,151,160,0,219,219,81
306,1121816,0,4,80,0,84,84,151,160,0,219,219,81
311,1121944,0,23,20,0,43,43,151,160,0,219,219,81
292,1121368,0,4,60,0,64,64,151,160,0,219,219,81
315,1122072,0,4,40,0,44,44,151,160,0,219,219,81
308,1121880,0,23,80,0,103,103,151,160,0,219,219,81
313,1122008,0,23,20,0,43,43,151,160,0,219,219,81
297,1121496,0,49,60,0,109,109,151,160,0,219,219,81
323,1122328,0,7,80,0,87,87,151,160,0,219,219,81
299,1121624,0,23,20,0,43,43,151,160,0,219,219,81
304,1121752,0,23,60,0,83,83,151,160,0,219,219,81
318,1122200,0,4,100,0,104,104,151,160,0,219,219,81
320,1122264,0,23,20,0,43,43,151,160,0,219,219,81
325,1122392,0,4,20,0,24,24,151,160,0,219,219,80
327,1122456,0,4,20,0,24,24,151,160,0,219,219,80
331,1122584,0,43,20,0,63,63,151,160,0,219,219,80
333,1122648,0,4,20,0,24,24,151,160,0,219,219,79
316,1122136,0,4,20,0,24,24,151,160,0,219,219,79
338,1122776,0,67,100,0,167,167,151,160,0,219,219,80
342,1122840,0,4,40,0,44,44,151,160,0,219,219,79
343,1122904,0,4,20,0,24,24,151,160,0,219,219,79
328,1122520,0,4,20,0,24,24,151,160,0,219,219,79
345,1122968,0,4,80,0,84,84,151,160,0,219,219,79
347,1123096,0,4,20,0,24,24,151,160,0,219,219,79
352,1123224,0,75,60,0,135,135,151,160,0,219,219,79
356,1123352,0,4,20,0,24,24,151,160,0,219,219,79
335,1122712,0,129,20,0,149,149,151,160,0,219,219,79
346,1123032,0,4,60,0,64,64,151,160,0,219,219,79
361,1123544,0,4,100,0,104,104,151,160,0,219,219,79
357,1123416,0,89,20,0,109,109,151,160,0,219,219,79
354,1123288,0,4,40,0,44,44,151,160,0,219,219,79
348,1123160,0,137,20,0,157,157,151,160,0,219,219,79
359,1123480,0,47,100,0,147,147,151,160,0,219,219,80
